#D########
#.#...####
#...#...##
#######..#
########A#