#D########
#.#2....3#
#0.1####.#
########.#
########A#