#D########
#.#C....C#
#C.C####.#
########.#
########A#