#D########
#.#3....4#
#1.2####.#
########.#
########A#